
#Default
Наушник === тот кто говорит клевет
Наушничать === клеватеть за спиной
Тяжба === спор
Погожий === благоприятный в отношении погоды
Неистовый === черезвычайно сильный в своем проялении
Тщедушный === хилый, слабый
Литургия === богослужение
Моногамия === один парнер
Полигамия === много
Промискуитет === беспорядочная половая связь с многими партнерами
Антагони́зм === соперничество, конкуренция, борьба, противостояние, противоречия.
Паритет === равенство взаимоотношений двух или более сторон по каким-либо параметрам.
Скрупулёзный === чрезвычайно тщательный, точный до мелочей.
Невозмутимый === проявляющий самообладание; очень спокойный.
Ретроград === противник прогресса, человек с отсталыми взглядами.
Аутентичный === подлинный, исходящий из первоисточника.
Ассимиляция === уравнение, уподобление.
Мизантроп === Человек, ненавидящий людей, чуждающийся их.
Латентность === Свойство объектов или процессов находиться в скрытом состоянии, не проявляя себя явным образом (от латинского latentis «скрытый»).
Шовинизм === Крайний национализм, проповедующий ненависть, презрение к другим народам и разжигающий национальную вражду (от имени французского солдата Chovin, восторженного поклонника завоевательной политики Наполеона).
Патетический === Страстный, взволнованный, исполненный пафоса (от греческого pathos «страсть»).
Эвфемизм === Слово или выражение, заменяющее другое, неудобное для данной обстановки или грубое (от греческого euphemeo «говорю вежливо»).
Идиосинкразия === непереносимость. Например: У меня к дуракам идиосинкразия! 
Трансцендентальный === отвлеченный, абстрактный, академический, мысленный, умозрительный, умственный, теоретический. 
Метросексуал === эвфемизм педераста.
Эзотерика === тайное учение. Более о нем ничего не известно. 
Глоссарий === Список аббревиатур и сокращений. 
Декадентство === упадничество. Термин хорош для оценки любых действий любых персонажей. Напр.: "Какое декадентство!" 
Конгруэнтность === открытость, честность. Конгруэнтным называют человека, который сознает и принимает чувства/ощущения, которые испытывает, может назвать их и выразить в поведении нетравмирующим для окружающих способом.
Прения === выступления сторон в судебном процессе. обсуждение какого-либо вопроса, публичный спор по каким-либо вопросам.
Визави === своим визави вы имеете полное право назвать того, кто находится напротив вас, с кем вы сидите лицом к лицу.
Инсайт === внезапное понимание чего-либо, не выводимое из прошлого опыта. === У меня был инсайт!
Синергия === суммированный эффект превышает отдачу от действий каждого участника процесса в отдельности.
Дистопия === антиутопия, жанр в художественной литературе, описывающий государство, в котором возобладали негативные тенденции развития
Лю́мпен === термин, введённый Карлом Марксом для обозначения низших слоёв пролетариата. Позднее люмпенами стали называться все деклассированные слои населения (бродяги, нищие, уголовные элементы и другие асоциальные личности). В большинстве случаев люмпен === это лицо, не имеющее никакой собственности и живущее случайными заработками или пользующееся государственными социальными пособиями в различных формах.
Прослыть === заслужить, получить какую-либо репутацию, стать известным в качестве кого-либо, чего-либо
Лоскут === кусок, обрывок ткани
Горемыка === тот, кого постоянно преследуют всевозможные несчастья, беды, нужда, лишения;
Щуплый === худенький
Коренастый === имеющий крепкое сложение, широкоплечий, но невысокий
Аскет === человек, избравший путь воздержания и строгий образ жизни, предполагающий ограничения в получении удовольствий и использовании материальных благ
Тенор === это высокий певческий мужской голос
Веха === значимое событие в истории или развитии чего-либо.
Фужер === стеклянная посуда
Пневматический === приводимый в действие сжатым воздухом
Инфантилизм === отсталость в развитии, проявляющаяся в сохранении у взрослого физических или психических черт, свойственных ребёнку
Малодушие === слабость характера, часто выраженная в трусости, мелкой зависти и непроизвольной агрессии. Малодушие часто проистекает из-за недостатка силы воли и уверенности в себе. В отличие от депрессии, малодушие === это черта характера, а не временное состояние психики человека.
Хаки === Название цвета материи, введенной у нас в войсках после русско японской войны: защитный цвет, зеленовато коричнево серый.
Хаки === военные верхние рубашки у японцев из джутовой или бумажной материи желтоватого цвета с поясом, для офицеров и нижних чинов.
Сублима́ция === защитный механизм психики, представляющий собой снятие внутреннего напряжения с помощью перенаправления энергии на достижение социально приемлемых целей, творчество. Впервые описан Фрейдом. Зигмунд Фрейд, в соответствии с концепциями своей теории, описывал сублимацию как отклонение энергии биологических, в первую очередь сексуальных влечений от их прямой цели и перенаправление её к социально приемлемым целям. 
Тата́ми === маты, которыми в Японии застилают полы домов (традиционного типа). Плетутся из тростника игуса и набиваются рисовой соломой, хотя в последнее время для набивки используется и синтетическая вата. Длинные края татами обшиваются тканью.
Отдушина === отверстие для выхода воздуха, то, что дает выход каким-либо чувствам, стремлениям, настроениям.
Метать бисер перед свиньями === ирон. напрасно говорить о чём-либо или доказывать что-либо тому, кто не способен или не хочет ни понять, ни оценить это должным образом.
Мизогини́я === понятие, обозначающее ненависть, неприязнь, либо укоренившееся предубеждение по отношению к женщинам, женоненавистничество. Мизогинист - человек, которому свойственна мизогиния. Мизогиния может проявляться в форме дискриминации по признаку пола, принижения женщин, насилия над женщинами или сексуальной объективации женщин.
Богаде́льня === благотворительное заведение для содержания нетрудоспособных лиц (престарелых, немощных, инвалидов, калек и выздоравливающих). 
Погожий === хороший, благоприятный в отношении погоды. === Утро стояло погожее, но неприятное: ветреное и красное.
Продрогнуть === озябнуть сильно, до дрожи, до озноба. === Продрогнуть на морозе.
Озябнуть === разг. ощутить холод, замёрзнуть. === Метель не унималась до утра, а так как люди и лошади озябли, то и решено было вернуться к биваку.
Тщедушный === Хилый, слабосильный. === Тщедушный вид. Тщедушный старик.
Вольготный === разг. ничем не стеснённый; свободный, привольный. === Только с той поры Данилушке не стало вольготного житья.
Магнолия === род цветковых растений семейства Магнолиевые (Magnoliaceae), содержащий около 240 видов.
Пестовать === Нянчить (устар.). === 25 лет пестовал товарищ Ленин нашу партию и выпестовал ее, как самую крепкую и самую закаленную.
Люстрация === законодательные ограничения, вводимые после смены власти для ограничения прав сторонников прежней власти. Предполагается, что осуществление люстрации должно придавать легитимность новой власти путём решительного разрыва с практикой старой власти, воспринимающейся как преступная и неправовая.
Политический плюрализм === это принцип, содействующий существованию многообразия политических сил с конкуренцией между ними за представительство в органах государственной власти. Он предполагает легальное столкновение интересов, дискуссии между сторонниками различных точек зрения. Другими словами — многопартийность.
Антагонизм === враждебное противодействие, вызванное несогласием во мнениях или интересах === Антагонизм между родителями и детьми. Ясно, что стороны эти не могут понимать друг друга и что из этого должен произойти антагонизм.
Речистый === легко, красиво говорящий; красноречивый === О Марк Туллий! О ты, речистый самый Из праправнуков Ромула на свете.
Облобызать === устар., ирон. поцеловать, расцеловать === Облобызал я прах ног его.
Бенефициар === какое-либо заинтересованное лицо в чём-либо, интересант === И когда Маниту покарает нас ― а рано или поздно такое случится, ― бенефициаров этого святотатства не спасут ни счета, ни сокровища.
Интересант === устар. тот, кто в своих поступках руководствуется исключительно личным расчётом, корыстью, выгодой
Кануть в Лету === книжн., экспр. бесследно и навсегда исчезнуть, уйти в небытие (о человеке), быть навечно забытым, преданным забвению (о событиях, фактах, воспоминаниях) === И затем Подгоняйчиков, со всею помадой и новыми брюками, навек канул в Лету.
Ле́та === в древнегреческой мифологии источник и одна из пяти рек (вместе со Стиксом, Ахероном, Кокитосом и Флегетоном), протекающих в подземном царстве Аида, река забвения. Первоначально упоминалась равнина Леты. По прибытии в подземное царство умершие пили из этой реки и получали забвение всего прошедшего; наоборот, те, которые отправлялись обратно на землю, должны были ещё раз напиться воды из подземной реки.
Аи́д === в древнегреческой мифологии — бог подземного царства мёртвых и название самого царства мёртвых. Старший сын Кроноса и Реи, брат Зевса, Посейдона, Геры, Деметры и Гестии. Супруг Персефоны, вместе с ним почитаемой и призываемой.
Зиккура́т === многоступенчатое культовое сооружение в Древней Месопотамии и Эламе, типичное для шумерской, ассирийской, вавилонской и эламской архитектуры.
Метроло́гия === наука об измерениях, методах и средствах обеспечения их единства и способах достижения требуемой точности. Предметом метрологии является извлечение количественной информации о свойствах объектов с заданной точностью и достоверностью; нормативная база для этого — метрологические стандарты.
Паперть === церк. площадка перед входом в православную церковь === Вышел правитель из церкви, остановился на паперти, дал знак рукой, и вся толпа стихла.
Вожжи === Часть упряжи, состоящая из длинных ремней или веревок и служащая для того, чтобы править лошадью. ===  Натянуть вожжи. Отпустить вожжи. Хлестнуть лошадь вожжой.
Лыка не вязать === об очень пьяном человеке, не способном координировать свои движения и связно говорить === Дьячок с букварём, псалтырем, с указкой и с книжками, одна грязнее и глупее другой, сильно зашибал, очень любил «монаха», как называл он косушку вина и часто являлся он к барину на урок в таком виде, что лыка не вязал и, сидя за столом, кивал носом, пьяно и глупо хихикал без причины или вдруг принимался горько плакать.
Экстатический === книжн. вызванный экстазом, связанный с экстазом, проникнутый экстазом === Я же докажу, что подавление шаманского гнозиса с его опорой на экстатическое растворение "эго" и настаиванием на таком растворении лишило нас смысла жизни и сделало врагами планеты, самих себя и своих внуков.
Шовинизм === идеология, суть которой заключается в проповеди национального превосходства с целью обоснования «права» на дискриминацию, эксплуатацию и угнетение других народов. Шовинизм способствует возникновению и распространению неприязни и даже ненависти к чужакам, иноземцам, иноверцам, по принципу «не такой — чужой — чужак — враг». Одна из форм гетерономии и ксенофобии. === Несмотря на свой крайний шовинизм, он, однако, вынужден был признаться в докладе своему правительству «В присутствие миноносцев я сам в конце концов потерял всякую веру, а отстаивать эту версию при таких условиях было, разумеется, невозможно.»
Ксенофобия === неприязнь к кому-либо или чему-либо чужому; восприятие чужого как неприятного. Возведённая в ранг мировоззрения, может стать причиной вражды по принципу национального, религиозного или социального деления людей.
Мизогиния === понятие, обозначающее ненависть, неприязнь, либо укоренившееся предубеждение по отношению к женщинам. Мизогиния может проявляться в форме дискриминации по признаку пола, принижения женщин, насилия над женщинами или сексуальной объективации женщин.

#/


#Katet songs
Архистратиг === титул главнокомандующего в Древней Греции; эпитет архангелов, военачальников ангельских небесных сил. Наиболее часто употреблятся как эпитет Архангела Михаила.
Гострайтер === лицо, пишущее тексты (гл. обр. публичных речей) для другого лица, выступающего как предполагаемый автор.
Исполин === человек очень высокого роста, крупного телосложения; великан, богатырь.
Танатофобия === патологический страх смерти.
Квёлый === разг. слабый, хилый.

#/


#Проект увечье songs
Пандора === в мифах древних греков первая женщина, созданная Афиной и Гефестом. Зевс, разгневанный тем, что Прометей похитил для людей огонь у богов, в отместку решил создать женщину. Гефест слепил её, смешав землю с водой, Афина одела её в серебряное платье и увенчала золотым венцом. По замыслу Зевса, Пандора должна была принести людям соблазны и несчастья. Она пленила своей красотой брата Прометея — Эпиметея и стала его женой. Когда Пандора открыла сосуд, вручённый ей богами, в который были заключены все людские пороки и несчастья, по земле расползлись болезни и бедствия. Только надежда осталась на дне сосуда, так как Пандора захлопнула крышку; так люди лишились даже надежды на лучшую жизнь.
Пилигрим === перен. странник, путник === Я утешал его, объяснял, что вообще-то и герань не русский цветок, герань пилигрим с далёкого юга планеты…
Тесьма́ === узкая тканая или плетёная полоска или шнур, обычно имеющая только одну систему косо переплетёных нитей. Используется для отделки и ремонта одежды, нередко вшивается в готовые изделия для укрепления швов, кроме этого имеет самое разнообразное применение в домашнем обиходе. 
Натореть === разг. приобретать навык, сноровку в каком-либо деле === Но скоро люди научились бороться с цингой, наторели плавать на лодках и кунгасах, реже выпадали за борт, не лазили дуром по тундре, в бараке извелась пьянь и блатняки.
Синопсис === в научной номенклатуре древних греков означало изложение в одном общем обзоре, в сжатой форме, без подробной аргументации и без детальных теоретических рассуждений одного целого предмета или одной области знаний. === Такой вот нехитрый синопсис.
Опостылеть === разг. стать постылым; надоесть === Эта жизнь опостылела мне, — продолжала Надя, — я не вынесу здесь и одного дня.
Ика́р === в древнегреческой мифологии сын Дедала и рабыни Навкраты, известный своей необычной смертью. По сюжету легенды о Дедале и Икаре создано множество произведений. Чтобы спастись с острова Крит от раздражённого Миноса, мастер Дедал сделал для себя и сына крылья, скреплённые воском, и Дедал просил: «Не поднимайся слишком высоко; солнце растопит воск. Не лети слишком низко; морская вода попадёт на перья и они намокнут». Но уже во время перелёта в Элладу Икар настолько увлекся полётом, что забыл наставление отца и поднялся очень высоко, приблизившись слишком близко к Солнцу. Лучи Солнца растопили воск, в результате Икар упал и утонул[2] недалеко от острова Самос в море, которое и получило в этой части название Икарийского. Его тело, прибитое волнами к берегу, было похоронено Гераклом на маленьком островке Долиха, названном по его имени Икария. Древние греки классического и более поздних периодов думали, что в форме мифа об Икаре и Дедале сохранилось воспоминание об изобретении косых парусов — по распространённой интерпретации, Дедал и Икар спаслись с Крита просто на корабле с косыми парусами, позволяющими использовать не только попутный, но и боковой и даже встречный ветер. До этого изобретения использовались только прямые паруса. Икар во время плавания упал за борт и утонул.
Хартленд === массивная северо-восточная часть Евразии, окаймляемая с юга и востока горными системами, однако её границы определяются по-разному различными исследователями.
Протагонист ===  главный герой, центральное действующее лицо, актёр, играющий главную роль в произведении и т. д. Противопоставляется антагонисту.
Антагонист === в художественном произведении: персонаж, противодействующий главному герою (протагонисту) на пути к достижению его целей. Противостояние антагонист-протагонист является одной из возможных движущих сил центрального конфликта произведения. Действия антагониста не только создают препятствия, которые протагонист должен преодолевать, но и могут служить причиной развития характера протагониста.
Монисто === изделие (ожерелье) из жемчуга, монет, бляшек, бисера, бус, обработанных разноцветных камней, кораллов и так далее, указывало на социальный статус его носительницы.
Путешествие в Икстлан === третья книга Карлоса Кастанеды. Икстлан (топоним ацтекского происхождения) оказывается метафорической родиной, на которую пытается вернуться «человек знания». Приобретённое знание делает его непохожим на обычных людей, которые кажутся ему всего лишь «призраками». Суть истории заключается в том, что после того, как человек приобретает «знание», он уже больше никогда не может вернуться домой, к своему прежнему образу жизни.
Невро́з, психоневро́з, невроти́ческое расстройство === устаревшее название группы нервно-психических расстройств, возникающих по причине острых и хронических психологических травм и характеризующихся отсутствием качественных изменений психической деятельности. Клиническая картина таких расстройств характеризуется астеническими, навязчивыми или истерическими проявлениями, а также временным снижением умственной и физической работоспособности.
Иннсмут === вымышленный город, созданный Говардом Филлипсом Лавкрафтом; небольшой портовый городок, расположенный в штате Массачусетс, недалеко от Аркхема. Собирательный образ всех опустевших городков США.
Делирий === психическое расстройство, протекающее с помрачением сознания, нарушением внимания, восприятия, мышления и эмоций. Характеризуется наличием истинных, преимущественно зрительных, галлюцинаций и иллюзий, и, как следствие, — вторичным бредом; наличием эмоциональных (аффективных) нарушений, сенестопатиями, затруднённой ориентировкой в окружающем мире, дезориентацией во времени. При этом сохраняются осознание собственной личности и опасностей. Эмоциональное состояние больного зависит от характера протекаемых галлюцинаций. Больной может быть опасен для себя и окружающих. После выхода из делирия — частичная конградная амнезия (амнезируются реальные события и болезненные воспоминания).
Прозаический === перен. непоэтичный, лишённый возвышенности, неинтересный, будничный; обыденный
Травить === спец. на охоте — преследовать дичь с собаками === Только что я видел французского посла, - он ехал с великолепнейшими английскими борзыми — травить зайцев по пороше… 
Травить === перен., разг. изводить, причинять страдания === На общем собрании они решили «травить» нового инспектора при первом же случае.
Десница === правая рука. В русском языке слово является архаизмом, используется как стилистически маркированное слово (номинально, в высоком стиле), а также в некоторых устойчивых словосочетаниях или контекстах. Одесну́ю — по правую руку, справа.
Архаи́зм === устаревшая лексика, устаревшее слово, которое в современной речи заменено синонимом.
Рьяный === энергично и с увлечением занимающийся чем-либо === Аркадий сделался рьяным хозяином, и «ферма» уже приносит довольно значительный доход.


#/


#Horus songs
Вельвет === хлопчатобумажная ткань с густым ворсом, напоминающая бархат и имеющая продольные рубчики на лицевой стороне === Для тебя нет мест под небес серым вельветом.
Отпетый === разг. пропащий, конченый === Сколько дурней отбитых превратилось в отпетых.
Кастом === автомоб. транспортное средство (обычно о мотоцикле), изготовленное в единственном или крайне малом количестве экземпляров
Кайло === ручной инструмент для откалывания кусков ломких пород; кирка === Все давно предрешено, допивай одеколон. Полируй свой черенок да резвей маши кайлом.
Тлеть === сгорать или гореть без пламени / разрушаться от гниения, разлагаться, гнить === Если задуматься — смех разбирает. Насколько нелепы, избиты и тленны.
Анфилада === хит. ряд примыкающих друг к другу помещений, дверные проёмы которых расположены по одной оси, что создает сквозную перспективу интерьеров === Блоков анфилады и коридоры. В небе — Луны тёртый луидор.
Луидор === истор. старинная французская золотая монета === Блоков анфилады и коридоры. В небе — Луны тёртый луидор.
Короста === гнойные струпья на коже (обычно при чесотке) === Срезал его, как коросту — медленно, за слоем слой.
Струп === сухая корочка, покрывающая поверхность пораженной болезнью кожи или края заживающей раны, ссадины === Сам дядя Ерошка лежал навзничь на коротенькой кровати, устроенной между стеной и печкой, в одной рубашке, и, задрав сильные ноги на печку, колупал толстым пальцем струпы на руках, исцарапанных ястребом, которого он вынашивал без перчатки.
Нарратив === лингв. текст, построенный по принципу развёртывания ремы (повествования) === И это чудеса если поймут, не извратив. Поскольку я не сократил нравственный нарратив.
Претить === устар. запрещать что-либо, препятствовать чему-либо === Но что-то этому претит. Моя мораль стара — Нас накормить дерьмом старается медиаресторан.
Подоплёка === перен. скрытая причина, основа, сущность чего-либо === Кто-то упорно утверждал, что рэп для недалёких. Кому нужны слова не видящих всей подоплеки?
Клерк  === конторский служащий, ведущий делопроизводство === Словно сучий клерк в рот засунешь глок.
Космогония === учение о происхождении или о сотворении Вселенной === Изучил, как механизм часов. Заглянул за кулисы этой космогонии. Я все понял.

#/


#ATL songs
Ахинея === вздор, бессмыслица.
Манди́булы, или жвалы === верхние (парные) челюсти членистоногих.
Ксеноморф === пришелец из чужого.
Силок === приспособление для ловли птиц и мелких животных. Обычно представляет собой конструкцию, сооружённую из подручных материалов. Это верёвочная петля, привязанная или прикреплённая к дереву или колу.
Сонм === устар., книжн. собрание, сборище; толпа. Около неё теснится сонм прекрасных, умных, приветливых и любезных существ.
Ветошь === ветхая одежда, ветхие вещи; отходы текстильного производства. === Тихо спой мне, куда идешь ты. Свою новую демку тошную. Облаченную в стильную ветошь
Треба === церк. нерегулярный церковный обряд, совершаемый по просьбе прихожанина. === Этот священный рэйв требует чудовищных треб.
Лобызать === устар. или ирон. то же, что целовать === И ты у нас будешь грызть гранит да лобызать вселенной лоны.
Присно === церк.-слав.. то же, что всегда  === Если бошка твоя отличная призма === отличный признак. Значит, я буду облучать ее искренне отныне присно.
Астрал === разг. состояние погружённости в себя, при котором происходит перемещение духовной сущности человека за пределы околоземного пространства. === В астрал отправится этот экспресс.
Сла́нцы === разнообразные горные породы с параллельным (слоистым) расположением срастаний низко- или среднетемпературных минералов (таких как хлорит, актинолит, серицит, серпентин, эпидот, мусковит, альбит, кварц, ставролит), входящих в их состав; в них часто сохраняются реликтовые структуры. === Под землей мертвецы шаркают сланцами.
Аршин === старорусская единица измерения длины. 1 аршин = 0,7112 м; (растояние от пальцев до плеча) === Танцпол этот наш не измерить аршином.
Расторопный === быстрый, ловкий. === Опа, мы по секретным тропам. Тянем тяжко и нерасторопно.
Пиро́га === ставшее традиционным название лодок экзотических народов. === Громко, бей в бубен до гроба. Пока на этом свете твоя пирога.
Хворь === прост. болезнь, недомогание, нездоровье === В надежде избавиться от этой хвори. Тебя манят в лес лишь мухоморы (что?).
Грай === нар.-поэт. громкий беспорядочный птичий крик. === Вороний грай.
Харчок === диал., разг., прост. мокрота, отплюнутая из носо-ротовой полости человека; плевок с отхаркиванием. === Смачно упадет души моей харчок.
Кляча === разг., пренебр. не́мощная, старая или больная лошадь (обычно про животное, впряжённое в телегу). === А на той своей в хламине битой кляче.
Давеча === устар. или прост. некоторое время назад (обычно в течение текущего дня), незадолго до момента разговора, недавно, намедни, на днях. === Эх эта печаль. Режет горло ацетоном. Её давеча найдут около забора.
Ода === жанр лирики, представляющий собою торжественное стихотворение, посвящённое какому-либо событию или герою.
Аморфный === расплывчатый, бесформенный, неопределённый. === Невыкупающие аморфные существа.
Променад === прогулка, гуляние. === Ты лучше припомни наши променады.
Одиссея === богатые событиями странствия, горестные скитания. === Космос === одиссея в один конец. Слышишь, прощай земля.
Пена́ты === в древнеримской мифологии боги-хранители и покровители домашнего очага. === Под реквием по родным пенатам.
Кропалик (кропали) === кроха, чуть-чуть, немножечко, небольшое количество чего-либо. === Шаманы в лесу, как в траве муравьи. От себя я оставлю лишь кропали.

Свита === лица, сопровождающие высокопоставленную особу. === Нас тут целая свита, и мы по кругу запустим этот свиток.
Скрэббл === настольная игра, в которой от двух до четырёх играющих соревнуются в образовании слов с использованием буквенных деревянных плиток на доске, разбитой на 225 квадратов. В русскоязычной среде известна также под названиями «Эрудит» или «Словодел». === Не просто игры в скрэббл - это и есть та любовь до гроба.
Ри́ддим === инструментальная версия песни, присущая ямайской музыке и другим стилям музыки карибского бассейна. Риддим обычно содержит партию ударных и повторяющуюся басовую партию. === Это босяцкий подгончик свыше, чтобы убить зубастый риддим.
Ве́ды === сборник самых древних священных писаний индуизма на санскрите. === А счастье то в бедах, в олимпийках, да кедах. Мы трем тут свои прогрессивные веды.
Ультрамарин === яркая синяя краска, также яркий синий цвет. === К облакам напрямик, сквозь ультрамарин. Этот состав поезда тронется.
Гаметы, или половые клетки, === репродуктивные клетки, имеющие гаплоидный (одинарный) набор хромосом и участвующие, в частности, в половом размножении. При слиянии двух гамет в половом процессе образуется зигота, развивающаяся в особь (или группу особей) с наследственными признаками обоих родительских организмов, произведших гаметы. === И меня не станет вдруг на этом треке. Отныне будет некому метать гаметы.
Парапе́т === Невысокая стенка, ограждающая кровлю здания, террасу, балкон, набережную, мост и тому подобное. Парапет часто служит постаментом для декоративных ваз и статуй. === Вслед за людьми взлетят асфальт и парапеты.
Инферно === религ. ад, крупный пожар. === Вырастут на горизонте грибы из пепла. Цветы из плоти, инферно. Пекло.
Пангея === сверхконтинент, существовавший в конце палеозоя и начале мезозоя и объединявший практически всю сушу Земли 335-175 млн лет назад === Гондвану, Лаврентию, Балтию и Сибирь. === Земля по шву порвется как Пангея.
Апогей === астрон. точка орбиты Луны или искусственного спутника Земли, наиболее удаленная от центра Земли, перен. высшая точка, предельная степень развития чего-либо; взлёт, расцвет. === Когда симфония огня достигнет апогея.
Ареола === пигментированная область вокруг соска. === Под созвездием Ориона. Мелькнет ее нежная ареола.
Гобелен === один из видов декоративно-прикладного искусства, стенной односторонний безворсовый ковёр с сюжетной или орнаментальной композицией, вытканный вручную перекрёстным переплетением нитей. === Тут звезды ткут гобелены. Бесконечным небосводом червивым.

Балдахин === нарядный декоративный навес на консолях или столбиках над троном, кафедрой проповедника, парадным ложем, церковным алтарём и т. п. === Он очутился в огромной дворцовой зале, на золотом троне, под пурпуровым балдахином, и вокруг него толпилась послушная толпа сановников и слуг.
Партак === крим. жарг. татуировка === Миротворец вернулся с тарелкой на табурет и принялся за еду, он, гонимый мыслью о том, что в его доме харчуется «чухан», не удержался от реплики: — Фантик, это тебе на малолетке надолбили столь гнусный партак?
Трель === непродолжительный мелодичный звук === Хотел сказать, что накануне мне приснилась трель мёртвых соловьёв.
Карбонад === свиное филе, жаренное или запечённое с чесноком, мускатным орехом === Мы все пойдём на сервелат, все пойдём на карбонад. Я всех животных приглашаю к нам на мясокомбинат.
Фортель === разг. ловкая проделка, хитроумный приём, неожиданная выходка === Пусть судьбинушка выкинет фортель. Отобедать потребует дёгтем.
Авоська === разг. сетчатая сумка для продуктов, мелких предметов и т. п.; сетка === Пусть Родина ласково. В путь соберёт мне бутылок авоську. Распластав меня на теплотрассе. Снежным ангелом пьяным в доску.
Ливрея === в богатых домах и при дворах — форменная одежда особого покроя и определённого цвета для лакеев, швейцаров, кучеров и иных слуг === И на лакее ливрея какая, Данилыч: сукно английское, по 5 рублей аршин; он суровый такой, важный, но учтив, отвечает; давал и пробовать на рукаве, отличное сукно.
Саркома === мед. злокачественная опухоль из различных типов соединительной ткани: эмбриональной, костной, мышечной и др. === На стеклянный глаз смартфона я снимаю фейерверк. Он в небе пухнет, как саркома. Что за дивный спецэффект?
Аляпистый === грубо, безвкусно сделанный === Тот самый грустный диск-жокей. В нелепом и аляпистом пиджаке.
Вензель === рисунок в виде переплетающихся линий === А ты стреляй, моя хорошая, стреляй. Пусть из раны, что меж ребёр, вьются дыма вензеля.
Эндометрий  === анат. слизистая оболочка матки, выстилающая её полость === И пусть твоей Вселенной отслоится эндометрий (но). Но я, блять, здесь ни при чём, вини Создателя планеты.
Насвай === вид некурительного табачного изделия, традиционный для Центральной Азии === Мечты укатили на Логане цвета насвая. Что под губой у водилы.


#/


#Alias
Бахрома === тесьма, один из краёв которой снабжён сплошным рядом мягких, свободно свисающих волокон, шнурков или других подвесок === Дело происходило в комнатке с почерневшими стенами, большой стряпущей печью и маленькими четырехугольными оконцами, к которым большими гвоздями были прибиты тончайшие кисейные занавески с бахромой из красных шерстинок.
Паперть === церк. площадка перед входом в православную церковь === Вышел правитель из церкви, остановился на паперти, дал знак рукой, и вся толпа стихла.
Мартинсы === обувь бренда Dr. Martens
Miu Miu === новый брен от Prada
Ламбруско === сорт красного винограда и производимое из него итальянское игристое или полуигристое вино, производимое преимущественно в областях Эмилия-Романья, Ломбардия и Пьемонт. Бывает в основном красным, но также розовым и белым, сухим, полусухим и полусладким.
Пайетка === или же блёстка - мелкая плоская либо рельефная чешуйка из блестящего материала круглой или многогранной формы, имеющая отверстие для продевания нитки для крепления на ткани или другом материале. Может иметь самую различную окраску и иметь как блестящую, так и матовую поверхность.
Трафарет для бровей === форма для вищипивыния бровей определенной формы
Фаркоп (ТСУ) === это тягово-сцепное устройство, которое используют для буксировки легких прицепов и трейлеров автомобилем
Лоббирование === это практика продвижения интересов различных финансово-промышленных групп, неправительственных организаций или этнических сообществ для достижения определенного решения. Лоббисты могут отстаивать государственные интересы на международной арене или общественные или частные интересы внутри страны.
Лоббировать === осуществлять давление на органы государственной власти, руководство чего-либо и т. п. в процессе принятия решений в интересах той или иной группировки (экономической, политической, национальной и т. п.) === Он должен лоббировать табакокурение, как это только возможно.

#/

#Car
Иммобилайзер (Иммобилизатор) === вид электронного противоугонного устройства. Предназначен надежно блокировать некоторые из модулей автомобиля или другого транспорта. Первичной задачей иммобилайзера является недопущения к управлению посторонних лиц, в том числе при попытках угона. Главная функция любого иммобилайзера состоит в блокировке двигателя автомобиля, если его пытаются похитить. В случае угона устройство должно препятствовать движению автомобиля своим ходом.
Мультируль === на самом деле это просто сокращение от мультифункциональный руль. Представляет собой обычный руль, на спицах которого расположены дополнительные кнопки для управления различными функциями в автомобиле. Чаще всего на руль переносятся кнопки управления аудиосистемой и бортового компьютера. В машинах подороже к ним может присоединиться управление куиз-контролем, Bluetooth, регулировка подвески и т.д..
Серворуль === система изменения усилия на руле, позволяющая при парковке крутить баранку одним пальцем, но придающая «вес» рулю на скорости.
ABS (АБС) === это антиблокировочная система, предотвращающая блокировку колес при торможении. Если во время торможения одно или несколько колес автомобиля заблокируются и начнут скользить по поверхности, АБС ослабит давление в соответствующей тормозной магистрали, и колесо вновь начнет вращаться. Если педаль тормоза будет постоянно и сильно нажата, этот процесс блокировки-разблокировки колеса будет продолжаться непрерывно до конца торможения и может осуществляться несколько раз в секунду. Главное предназначение — сохранить возможность управлять транспортным средством во время торможения, даже экстренного.



#/

#Books
Синдика === государство синдов, существовавшее с конца VI века до н. э. по IV век до н. э. === Пока Левкон был занят войной с Феодосией его брат закончил присоединение Синдики.
Антресоль === настил, полка под потолком либо верхняя часть шкафа для хранения вещей === На антресолях, кроме консервации и всякого строительного хлама, были фотоувеличитель, коробка с электробритвой «Харьков», диапроектор, целая стопка старых журналов «Кругозор» с голубыми пластинками-вкладышами.
Благоденствие === полное благополучие, процветание === Мир необходим для благоденствия страны.
Прелюбодеяние === устар. нарушение супружеской верности мужем или женой === О разводе же говорю вам, что кто разведется с женою, тот сам прелюбодействует и жену вводит в прелюбодеяние.
Ретироваться === разг., шутл. уходить (уйти), удаляться (удалиться) === Едва заговорили о котлетах, о простокваше, Александр начал искусно ретироваться.
Саван === религ. широкое погребальное одеяние из белой ткани для покойников в виде длинной рубахи, а также белый покров, которым накрывают тело в гробу === Что же касается гробов, то выручили еврейские обычаи, предписывающие хоронить покойника без гроба, завёрнутым в саван, гробы приносили обратно в гетто для новых покойников, гробов хватало, а вот когда стало не хватать саванов, то Штальбе приказал хоронить покойников без них, возвращать саваны в гетто и заворачивать в них других покойников. 
Распря === книжн. ссора, раздор, вражда === Почти нет никакого способа их усмирить, пока их не обезоружат, как обезоружили крымских татар, что чрезвычайно трудно исполнить, по причине господствующих между ими наследственных распрей и мщения крови. Педагог сам, своею собственною персоною, сделался предметом распри между отцом, который его гнал, и сыном, который за него заступался.
Агнец === устар. ягнёнок, барашек
Покаяние === добровольное признание в совершенном проступке, в ошибке, преступлении
Бравада === показная смелость, легкомысленная храбрость; бесцельно-дерзкое поведение
Розга === тонкая свежесрезанная ветка, прут, использовавшийся в качестве орудия наказания === Так отдеру тебя розгою, что ты и своих не узнаешь.
Вопиять === устар. громко, неистово кричать, издавать вопли; вопить
Пассат === постоянное воздушное течение в тропических широтах над океанами === Благодатный, ровно дующий пассат умеряет зной тропического дня, и томительной жары не чувствуется.
Реноме === книжн. установившееся, обычно благоприятное, мнение о ком-либо, чём-либо === И она ради сохранения реноме была готова на убыток.
Обелиск === памятник, каменное сооружение в виде столба (наиболее часто четырёхгранного), сужающегося кверху === Огромные иглы обелисков по пятьдесят локтей высоты, одетые листами ярко-жёлтого азема — сплава золота и серебра, горели как раскалённые, пронизывая жёсткую тёмную листву пальм.
Кудесник === нар.-поэт. волшебник; тот, кто делает что-либо сверхъестественное === Скажи мне, кудесник, любимец богов, // Что сбудется в жизни со мною? // И скоро ль, на радость соседей-врагов, // Могильной засыплюсь землёю? // Открой мне всю правду, не бойся меня: // В награду любого возьмешь ты коня.
Пиетет === книжн. глубокое уважение, почтительное отношение к кому-либо, чему-либо === К этому человеку все относились с большим пиететом.
Пересмешник === разг. тот, кто любит высмеивать, вышучивать
Мошна === река в России === Мошна — одна из многочисленных рек, протекающих по территории России.
Мощи === религ. высохшие останки (иногда — отдельные кости) людей, почитаемых церковью святыми, являющиеся объектом религиозного почитания в православии и католичестве
Аметист === драгоценный камень, синяя или фиолетовая разновидность кварца, употребляемая как украшение === Из всех камней мне больше амети́ст полюбился
Серна === парнокопытное млекопитающее из подсемейства козьих семейства полорогих, обитающее в Европе и Малой Азии.
Ареа́л === область распространения на земной поверхности какого-либо явления, определённого типа сообществ организмов, сходных условий (напр., ландшафтов) или объектов (напр., населённых мест); в биологии — область распространения и развития определённого таксона (вид, род и др.) или типа сообщества животных и растений. В медицине ареалом возбудителя болезни называют область естественного распространения возбудителя данного инфекционного заболевания.
Барельеф === разновидность скульптурного выпуклого рельефа, в котором изображение выступает над плоскостью фона не более, чем на половину объёма[1]; если более — горельеф («высокий рельеф»).
Предрассудок === суждение, усвоенное некритически, без размышления. Это иррациональные компоненты (стереотипы) общественного и индивидуального сознания: суеверия и предубеждения. Предрассудком считаются взгляды и мнения, основанные на неточном или искаженном знании, чаще всего принимаемые на веру со слов других людей.
Гроте́ск === искусств. художественный приём в литературе и искусстве, основанный на чрезмерном преувеличении, сочетании неожиданных и резких контрастов; также произведение литературы или искусства, использующее этот приём. орнамент в виде причудливо, фантастически переплетающихся растений, животных, фигурок людей, масок и т. п. === Но именно такие несуразности, абсурды, гротески записывал и записывал Чехов в свою потаенную книжку: о статском советнике, который ходит в театр лаять за кулисами собакой, чтобы получить за это лаяние рубль; о робком юноше, которому какая-то ведьма-старуха ночью по ошибке поставила клизму; о богаче, который застрелился от нужды, чувствуя себя нищим при ежегодном доходе в 50 тысяч рублей. 
Сваи === деревянные, металлические, бетонные, железобетонные или трубобетонные стержни цельные или полые внутри, которые заглубляются в вертикальном или наклонном положении в грунт, либо выполняются в грунте у оснований зданий и сооружений с целью передачи выдёргивающей, придавливающей или срезающей нагрузки от надземной части на грунт.
Мойры === в древнегреческой мифологии богини судьбы. У древних римлян Мойрам соответствовали Парки.
Монизм === филос. философское учение, признающее основой мира только одно начало (материю или дух). В отличие от дуализма и плюрализма, предполагающих существование двух и множества субстанций, монизм отличается большей внутренней последовательностью и монолитностью.
Дуали́зм === свойство некоторой теории или концепции, согласно которому в ней неразрывно сосуществуют два начала (силы, принципа, природы), несводимые друг к другу или даже противоположные. Дуализм противопоставляется монизму — воззрению, согласно которому разнообразие объектов в конечном счёте сводится к единому началу или субстанции, а также плюрализму, в соответствии с которым существует множество сил, принципов и начал.
Плюрали́зм === философская позиция, согласно которой существует множество различных равноправных, независимых и несводимых друг к другу основ или форм бытия (онтологический плюрализм), а значит и форм знания и методологий познания (эпистемологический плюрализм). Плюрализм занимает оппонирующую позицию по отношению к монизму.
Фавн === одно из древнейших национальных божеств Италии. Многие чисто италийские особенности его характера и культа сгладились вследствие отождествления его с греческим Паном. Фавн — добрый, милостивый бог. В образе Фавна древние италийцы почитали доброго духа гор, лугов, полей, пещер, стад, ниспосылающего плодородие полям, животным и людям, вещего бога, древнего царя Лациума и родоначальника многих древних фамилий, насадителя первоначальной культуры. При этом, наряду с единым личным божеством, верили в существование многих однородных и одноимённых с ним демонов, в которых были воплощены атрибуты самого Фавна. === Голос Фавна слышит римлянин в полях и лесах, когда вдруг раздастся какой-нибудь таинственный звук в полной тиши.
Валькирия === персонаж скандинавской мифологии. Дочь славного воина или конунга, которая реет на крылатом коне над полем битвы и решает, кому из воинов выжить в битве, а кому − погибнуть. Погибшие отправляются в небесный чертог — Вальхаллу. С гривы её коня (облака) капает оплодотворяющая роса, а от её меча исходит свет. === Предполагалось, что порой валькирии в лебяжьем оперении летали на землю к укромному ручью, где они могли порадовать себя купанием.
Атласный === имеющий гладкую блестящую поверхность, напоминающую атлас; атласное дерево – древесина некоторых древесных пород, получающая после полировки атласный блеск и идущая на изящные токарные и столярные изделия.
Психосоматика === мед. направление медицинской психологии, занимающееся изучением влияния психологических факторов на возникновение ряда соматических заболеваний
Соматическое заболевание === мед. заболевание не связанные с психической деятельностью человека, вызываемое внешними воздействиями или же внутренним нарушением работы органов и систем
Епитимья === перен., разг. добровольный отказ от чего-либо === А епитимья, которую он на себя наложил, действительно ужасна.
Викарий === церк. помощник епископа, епископ без епархии; в протестантской церкви: помощник священика; в англиканской церкви — приходский священник, получающий жалование или стипендию, но не собирающий десятину
Анфас === лицом к смотрящему. Уже в значении самого слова заключена предложная семантика. Употребление в анфас возникло под влиянием предложного сочетания в профиль, где профиль – существительное в значении «вид сбоку» === снимать крупные планы в анфас; на нее надо смотреть в анфас
Подаяние === пожертвование, которое делают кому-нибудь из милости, из сострадания; милостыня === Просить подаяние.
Платан === ботан. достигающее больших размеров дерево с зеленовато-серой корой и широкими лапчатыми листьями === Некогда Титир и Зоя, под тенью двух юных платанов, // Первые чувства познали любви и, полные счастья
Препарировать === изготовлять (изготовить) из чего-либо препарат === Я морских свинок очень даже люблю, Александр Николаевич говорит, их препарировать гораздо приятнее, чем крыс, например.
Подоплёка === перен. скрытая причина, основа, сущность чего-либо === Не знаю, наш ли это менталитет, или общая черта всех народов ― искать в каждом поступке подоплёку.
Ксенофобия === психиатр., психол. навязчивый страх перед незнакомыми людьми, боязнь чужих
Бить баклуши === праздно проводить время; бездельничать === Поздоровавшись, папа сказал, что будет нам в деревне баклуши бить, что мы перестали быть маленькими и что пора нам серьёзно учиться.
Бренный === книжн., высок. непрочный, слабый, подверженный разрушению === Уже готов // Он скоро бренный мир оставить; // Святой обряд он хочет править.
Инсинуация === книжн. клеветническое измышление, порочащее кого-либо === Твои грязные инсинуации не помешают мне добиться цели.
Вексель === фин. долговой документ строго установленной законом формы, содержащий обязательство уплатить определенную сумму денег в указанный срок
Заскорузлый === шершавый, загрубелый (о коже, коре и т. п.) === Погрузив спокойное лицо в заскорузлые ладони свои, как в чашу, неизвестный увидел, что девушка прилегла, беспомощно опустившись на локоть.
Изголовье === место, где в данный момент находится или обычно располагается голова лежащего или сидящего === Она́ постели́ла на пе́чке овчи́нный кожу́х, накры́ла его́ полоса́тым рядно́м, сняла́ с крова́ти большу́ю поду́шку и положи́ла её в изголовье. 
Сокрушаться === устар. гибнуть, рушиться === И вся эта перспектива должна сокрушаться от щелканья счетов, от разбиранья замасленных расписок мужиков, от обращения с фабричными! 
Мнительный === видящий во всём опасность, что-либо неблагоприятное; болезненно-подозрительный, недоверчивый === — С одной стороны, он должен взыграть, — рассуждал Кривицкий, — с другой, как человек мнительный, он подумает, что все были в заговоре против него.
Ипохондрия === книжн., мед. нервное расстройство, возникающее на почве болезненного страха перед заболеваниями, которые существуют только в расстроенном воображении больного
Реторта === хим. сосуд грушевидной формы с длинным отогнутым в сторону горлом, применяемый в лабораториях для нагревания и перегонки веществ === Натриевая соль тщательно перемешивалась с двойным по весу количеством трехсернистого фосфора и осторожно перегонялась порциями по 10 г из маленькой реторты.
Сеньораж === фин. доход от эмиссии денег
Регалия === истор., обычно мн. ч. предметы-символы гетманской, монархической и т. д. власти (булава, бунчук, знамя, корона, скипетр и т. п.) === Принятие Петром I в 1721 году императорского титула потребовало обновления церемониала и изменения состава символов власти — государственных регалий. 〈…〉 Тогда в составе регалий наряду с державой и скипетром, взятыми по указу Петра из Мастерской и Оружейной палаты, впервые появились императорская корона и мантия. 〈…〉 Специальный указ Комиссии от 16 апреля 1742 года был посвящён процессии регалий, в числе которых перечислялись корона, скипетр, держава, мантия.
Вотчина === истор. земельное владение, принадлежащее феодалу потомственно с правом продажи, залога, дарения === Село Болдино было настоящая боярская вотчина, три тысячи душ, да беда была в том, что в несчастном разделе, девять лет назад, принял участие и единородный сын отца от первого брака и оттягал большую часть земли и душ себе и своей матери.
Узурпировать === книжн. захватить, присвоить власть, полномочия, права и т. п., как правило, незаконно === Самое опасное и губительное для театра, когда группа узурпирует власть.
Оксюморон === стилистическая фигура, или стилистическая ошибка как сочетание слов с противоположным значением  === Такие несуразности филологи называют оксюморонами ― сухая вода и горячий снег из их числа.
Эмпатия === человек, чувствующий Ваши эмоции, переживания, а порой (если эмпатия сильная) даже Ваши физические ощущения, например, боль.
Утилитаризм === это направление в этике, согласно которому критерием нравственности является польза. Удовольствие и страдание – это измеримые величины и всегда можно рассчитать необходимую пропорцию между ними, а на основании этого решить, стоит или нет предпринимать то или иное действие. Добродетель – это не что иное, как максимальная польза для всего общества.
Прагматизм === это философское движение, рассматривающее любое познание, действие или идею с точки зрения практической пользы или целесообразности. Прагматичный человек — это человек разума. Он не живет понятиями «нравится – на нравится», а руководствуется критерием «полезно-бесполезно». А полезно для него только то, что действительно работает. Его действия и решения объясняются логикой и здравым смыслом. Прагматичный человек знает, чего хочет, умеет абстрагироваться от всего лишнего, ставит перед собой реальные цели и последовательно добивается результата.
Полимеры === хим. высокомолекулярное соединение, в котором атомы образуют линейные или разветвленные цепи, а также пространственные трёхмерные структуры. Полимерами могут быть неорганические и органические, аморфные и кристаллические вещества. === Из разных полимеров получали разнообразные пластмассы.
Абразив === твёрдый мелкозернистый материал, используемый при шлифовании, полировке, заточке и т. п. металлов, стекла, драгоценных камней и т. п. === ёрна абразива снимают мельчайшую стружку загрязнений — сначала с «выступов» поверхности изделия, а затем и со всей очищаемой площади.
Линчевать === подвергать (подвергнуть) суду Линча, то есть самосуду === Вчера вечером многотысячная толпа линчевала Негра, обвинявшегося в насилии над молодой девушкой, и сожгла его труп.
Суд Линча === убийство человека, подозреваемого в преступлении или нарушении общественных обычаев, без суда и следствия, обычно уличной толпой, путём повешения.
Сегрегация === полит., этнолог. вид расовой дискриминации, принудительное разделение групп населения по определенному социальному признаку, чаще всего — расовому и этническому === Рабство чернокожих отменили в 1865 году, и только через сто с лишним лет прекратилась расовая сегрегация.
Депеша === спешное уведомление, донесение === Произошла ошибка, и депешу передали исковерканной.
Поклёп === разг. несправедливое, намеренное искажение фактов о ком-либо, ложное обвинение в чём-либо; клевета === Поклёпы на диссидентов время от времени печатались во многих наших газетах…
Евангелист === перен. писатель-проповедник какой-либо идеи === Без сомнения, преступная идея важна. Она всегда выживала и выживет. У неё есть свои апостолы, мученики и евангелисты.
Евангелист === перен. торг. должность в компании, заключающаяся в создании идеологии компании, популяризации главных её технологий, коммуникации и внешних связях === Сейчас Винт Серф работает в корпорации Google, и является, как это принято говорить, евангелистом «поисковика».
Амвон === церк. находящаяся на возвышении перед алтарём площадка в христианском храме, используемая для произнесения проповедей === Мужиков набралось в церковь — вона! от притвора до амвона.
Плут === разг. ловкий и хитрый обманщик, нечестный в отношениях с людьми человек; мошенник === Мне этот Никанор Иванович не понравился. Он выжига и плут. Нельзя ли сделать так, чтобы он больше не приходил?
Плутовать === вести себя как плут; поступать нечестно в каком-либо деле, игре и т. п.; хитрить, лукавить, обманывать
Выжига === прост. пренебр. плут, пройдоха, прижимистый человек === Мне этот Никанор Иванович не понравился. Он выжига и плут.
Прижимистый === чрезмерно экономный, избегающий трат, издержек, расходования чего-либо.
Шаль === большой вязаный или тканый платок === Я снял с неё скользкую от снега шубку, она сбросила с волос на руки мне мокрую пуховую шаль и быстро прошла, шурша нижней шёлковой юбкой, в спальню.
Нигилизм === книжн. отрицание общепринятых ценностей: культуры, идеалов, моральных и правовых норм, авторитетов и т. п. === Как отмечает Ключевский, русское вольтерианство развивало радикализм и нигилизм.
Ирригация === спец. искусственное орошение земель, испытывающих недостаток влаги, для повышения их плодородия.
Фатум === книжн. неотвратимая судьба, рок, доля. === С первой встречи она поразила его, как бы заколдовала чем-то. Это был фатум.
Дрена === подземный искусственный водоток для сбора и отвода почвенных и грунтовых вод. === Воду из дрен, как правило, отводят в специальный дренажный колодец.





#/

#Instagram publics
Хронофаги === один из терминов управления временем, обозначающий любые отвлекающие объекты, мешающие и отвлекающие от основной деятельности (работы и других запланированных дел).
Хронофагия === пожирание, убийство времени посредством интеренета, тв, и т.д.
Клака === группа людей (клакёров), нанятых для аплодирования или освистывания, захлопывания артиста, оратора и т. п., чтобы создать впечатление успеха или, наоборот, провала выступления === Клака «заводит» зал: талант вознесут, посредственность провалят.
Палинфразия === Патологически частое повторение определенных слов или фраз в речи (блин, как бы)
Конформность === психол. зависимость человека от общественного мнения; склонность подчиняться, следовать нормам, установленным в группе или обществе. Стремление "быть таким как все"
Нимфа === мифол. в древнегреческой мифологии — второстепенное божество в виде молодой женщины, олицетворяющее различные силы и явления природы
Алармист === устар. тот, кто распространяет тревожные, часто необоснованные слухи; паникёр ===  Письмо это Авелан представил на благоусмотрение генерал-адмирала Алексея Александровича, но тот ответил: «Макаров известный алармист — никакой войны не будет».
Эксцесс === книжн. крайнее проявление чего-либо, обычно нарушающее норму, нормальное развитие === .. если coitus совершается без всякого понуждения перед отходом ко сну, после трудового дня, он совершенно нормален; coitus после сна и утренний — всегда эксцесс.
Феномен Баадера - Майнхоф (иллюзия частотности) === искажение человеческого мышления, заключающееся в том, что после того, как человек приобрел некую новую информацию, она, как ему кажется, начинает появляться повсюду.
Жамевю === психиатр. психическое расстройство, при котором больной воспринимает знакомые предметы, лица, обстановку как увиденные впервые
Силлогизм === книжн. логическое заключение, сделанное из двух посылок === Возьмём два факта: «Сократ — человек» и «Все люди смертны». Силлогизмом этих двух фактов будет «Сократ смертен».
Конгломерат === книжн. бессистемное соединение разнородных частей и предметов
Генезис === книжн. происхождение, возникновение, зарождение, начало чего-либо === Новелла — литературный малый повествовательный жанр, сопоставимый по объёму с рассказом, но отличающийся от него генезисом, историей и структурой.
Третировать === обращаться с кем-либо пренебрежительно, свысока, враждебно и агрессивно; не считаться с кем-либо === Она нас третировала, часто говорила гадости, пугала, что уйдет. 
Трюизм === книжн. самоочевидная, общеизвестная, избитая истина === A ведь это трюизм, что писатель должен видеть жизнь собственными глазами, слышать собственными ушами, думать о ней собственной головой.
Ноктюрн === муз. небольшое лирическое музыкальное произведение 
Канитель === ювел. очень тонкая металлическая нить, используемая для вышивания или для украшения / перен. разг. затяжное, нудное, хлопотное дело === Дело теперь объяснилось, главному факту мы соглашаемся верить, зачем же тянуть далее тяжелую и обидную канитель?
Истома === чувство приятной расслабленности === Мы с дедушкой усаживаемся на траву, откинувшись спиной на изгородь. Блаженная, сладкая истома. Позади нас кукурузное поле, впереди на десятки километров огромная равнина, с огромной стеной моря во весь горизонт.
Спесь === чванство, надменность, высокомерие === Завтра поезжай к своему тестю; но смотри, потешь его боярскую спесь; оставь сани у ворот; пройди через двор пешком; поговори с ним о его заслугах, о знатности ― и он будет от тебя без памяти.
Чванный === склонный к чванству; заносчивый, спесивый === Всякому гостю званому и нежданному привет от него был один, только чванных, спесивых да ломливых гостей он не жаловал. 
Вагабонд === устар. бездомный, бродяга === Правоверный вагабонд не имеет права на роздых  — он все время в движении, этот скандинавский дервиш, Агасфер приобочья.
Соловеть === становиться вялым, сонным.
Талион === Принцип назначения уголовного наказания за преступление, согласно которому мера наказания должна точно, буквально соответствовать вреду, причинённому вследствие совершения преступления («око за око, зуб за зуб»).
Имбецил === бранн. очень глупый человек, дурак
Брань === бранные, ругательные, оскорбительные, поносные слова (также в речи); ругань === Вдруг толпа гусаров окружила нас с ужасною бранью. 
Грымза === прост., бранн. женщина (обычно немолодая) с неприятной внешностью и плохим характером === От стола подняла на меня глаза женщина вилковских лет, грымза в очках, похожая на заведующую отделом кадров.
Увалень === разг. неповоротливый и ленивый человек  === Читатель может видеть, что Андрей Иванович Тентетников принадлежал к семейству тех людей, которых на Руси много, которым имена — увальни, лежебоки, байбаки и тому подобные. 
Овершерер === человек, который перебарщивает с количеством личной информации в соц. четях
Амбассадор === то же, что бренд-амбассадор; человек, нанятый организацией или компанией, чтобы представлять бренд в позитивном свете и тем самым способствовать повышению узнаваемости бренда и росту продаж
Маргинал === человек, не признающий общепринятых моральных норм и правил поведения === В последнее время не было скандальных высказываний политиков и экстремистских выходок маргиналов.
Филантроп === то же, что благотворитель; покровитель нуждающихся, приверженец благотворительности === Сегодня у памятника известного филантропа д-ра Ф. П. Гааза близ Александровской больницы экспромтом состоялось чествование биографа Газа А. Ф. Кони, приехавшего сегодня же в Москву.
Косность === склонность к чему-либо привычному, невосприимчивость к новому, прогрессивному; отсталость === С тупым упорством и застарелой, одеревеневшей косностью у нас продолжали выдавать желаемое за действительность, выхолащивать всякое сообщение, лицемерить, лгать и лгать, беззастенчиво, по всякому поводу…



#/

